1853 - Lifelover, Deprimat, Glädjekällor, Ofdrykkja, Vanhelga, Kall, As We Die, Eskapi, Meta/mor/fos, Neriak, Ritualmord, Epileptics;
A. - Totalselfhatred, Der Tod, Nocti Vagus, Die Pest, Nordwind, Horna, Korgonthurus, Nordlys, Austere, Fjell, Days of Saturn, Elfenwald, Orkburg;
A.C. - Nocturnal Depression, Exhaustus, Mother Augusta, Tulpa, Whiskey Ritual, Morbid Upheaval, Uncreation;
Abalam - Nocturnal Depression, Grim Landscape, Ruines Humaines;
Abriction - Sadness, Abriction;
Albert Batlle - Nocturnal Depression, Erzsébet, Evnar, Perennial Isolation, Crynight, Aeternal Mortuary, Cauldron, Inania Regna, Setge, Engraved;
Alex Damske - Sadness, Warforged, Screams of Winter;
Alex Menabde - Psychonaut 4, Signs;
Alex Quiroz - Sadness, Dismalimerence;
Algol - Nocturnal Depression, Forgotten Tomb, Hiems, The Tombers, The True Endless, SN, Mek Na Ver, Kirlian Camera, Poseidon, Triumph of Death;
André - Psychonaut 4, Sylvester the Cat, Empty Tears, Sense of Dispersal;
Apeng - Xasthur, Impiety, Vrykolakas, Oracle, Transgressor;
AQC - Kall, Kafziel, Galla, Hetroertzen, Mystruin, Verminking, Helfvetesqval;
Asher - Nocturnal Depression, Caronte, Whiskey Ritual, Domina Noctis, Willow at Moon, Dunkel Nacht, Forgotten Tomb, Tulpa, Kirlian Camera, Congregation of Misery, Psycho '78;
Avskrius - Nocturnal Depression, Mutilanova;
B - Lifelover, Dimhymn, IXXI, Ondskapt, Woundism;
Borger - Psychonaut 4, Signs, Circus Mircus, Gamouvali Mdgomareoba;
C. - Totalselfhatred, Korgonthurus, Ymir, Horna, Sear;
Caduccas - Xasthur, Abattory, Profancer, Disease;
Carl Ulvinen - Hypothermia, Malign, Monstraat, IXXI, Kafziel, Lifelover, Woundism;
D. Morbid - Forgotten Tomb, Beast of Hades, Black Goat, Deathxecutor, Majestic Terror, Morbid Holocaust, Necroripper, Nox, Electrocution, Critical Defiance, Putrid Yell, Terror Strike, Sick Violence, Hellpass, Tumba Olvidada;
Dagoth - Xasthur, Abhorer, Profancer, Abattory, Impiety, Demonification;
Damián Antón Ojeda - Sadness, Barbelith, Life, Liminal Dream, Ser, Trhä, An Open Letter, Born an Abomination, Kaskaskia, Left Alone..., ♡♡♡AMAZINGLAND♡♡♡, Camaleónica, Comforting, Exceeding Structure, Home Is in Your Arms, Nänmëë, RPG'97, A Nightlit Poesy, Aevilian, Citysad, Evocative Atmosphere, Évval, I Will Always Remember, Idiôm, Iniquitous Depression, Refisteuriv;
Demonica - Make a Change... Kill Yourself, Myrd, Plage, Angantyr, Holmgang, Monomania, Phrenetic, Usipian, Vardlokkur, Mara, Nocturnal Depression, Ad Noctum, Mzoraxc, Zahrim, Phantom (Dnk);
Drifter - Psychonaut 4, წრე (TSRE);
Elijah Cirricione - Sadness, Abscissor, Chloranthy, Dismalimerence, Meadows of Melancholy, Mouth of Sauron, In Autumnus, Vukari, Departer, The Place You Exist;
Feanor Omega - Make a Change... Kill Yourself, Feanor Omega, Sakrileg, Nebelfront, Svartsorg, Grimforst, Echelon, Scargod, (live), Tongueless Cuntkiller;
Fix - Lifelover, Kall;
Fredric Gråby - Lifelover, Bloodline, Chainsaw, Shining, Ondskapt;
Georg Börner - ColdWorld, Aznak, Sangre de Muérdago, Stórmir, Saeldes Sanc;
Giorgi Kordzakhia - Psychonaut 4, Signs;
Glixxx - Psychonaut 4, Im Nebel;
Graf - Psychonaut 4, Signs, Circus Mircus, Gamouvali Mdgomareoba;
Graham Southern - Sadness, Dismalimerence, Our Dying World, Graham Southern;
H. - Lifelover, Kall, Craft, Sällskapsresan;
Hans Cools - Hypothermia, Häxenzijrkell, Monads, Oerheks, Silver Knife, Aerdryk, Ignifer, Kilte, Tapetum Lucidum, The Apostasy, Trancelike Void, Toorn, Instinct, Guardian Heliotrope, Misere;
Herr Suizid - Nocturnal Depression, Grim Landscape, Helegion, Hexenkult, Livor Mortis, Terra Mortis, That Old Black Magic, Liquid Flesh, Myrd, Nostalgie, Make a Change... Kill Yourself, Psychonaut 4, Dead;
I. - Totalselfhatred, Goathorde, Morrigan, Night Must Fall, Uncreation's Dawn, Deepred, Thorngoat, Mayhemic Truth, Godless North, Limbless, Ordinance, Torsofuck, Barbatos, Ride for Revenge, Slugathor;
Irakli Kirkitadze - Psychonaut 4, Signs, Circus Mircus, Gamouvali Mdgomareoba;
J. - Totalselfhatred, Night Must Fall, General Winter, Tyranny, Slugathor;
Jason Nitts - Sadness, Roman Ring, Warforged, Sensory Deprivation;
Johan Gabrielson - Kall, Deprimat, Lifelover, Glädjekällor, Ofdrykkja, Vanhelga, As We Die, Eskapi, Meta/mor/fos, Neriak, Ritualmord, Epileptics (live);
Johannes - Hypothermia, Sitra Ahra, Kallbrand, Headsic;
Kim Carlssom - Kall, Hypothermia, Isolationist, Kyla, Life Is Pain, Lifelover, Black Hate, Svarti Loghin, Trist, A Symphony to the Void, Aardling, Consider Suicide, Horns Emerging, Nothing but Nothingness, Ritualmord;
Krahne - Nocturnal Depression, Helegion, Ordalie, Aldaaron, Electric Shock, Sanctuaire, Supplicium, Empires de Glace;
Kral - Lifelover, Canopy, Kall, Chainsaw, Decadence, Sterbhaus, A-Bros;
Leere - Silencer, Shining, Dethroned;
Lord Lokhraed - Make a Change... Kill Yourself, Grim Landscape, Helegion, Hexenkult, Nocturnal Depression, Livor Mortis, Terra Mortis, That Old Black Magic, Liquid Flesh, Myrd, Nostalgie, Psychonaut 4, Dead;
Lord Lokhraed - Nocturnal Depression, Grim Landscape, Helegion, Hexenkult, Livor Mortis, Terra Mortis, That Old Black Magic, Liquid Flesh, Myrd, Nostalgie, Make a Change... Kill Yourself, Psychonaut 4, Dead;
Lord Lokhraed - Psychonaut 4, Grim Landscape, Helegion, Hexenkult, Nocturnal Depression, Livor Mortis, Terra Mortis, That Old Black Magic, Liquid Flesh, Myrd, Nostalgie, Make a Change... Kill Yourself, Dead;
LR - Lifelover, Sdug Bsngal, Ritualmord;
Lydian Brambila - Sadness, Abriction;
M. - Totalselfhatred, Funeral Oath;
Martin Hansen - Totalselfhatred, Hedenskfrid, Norrhem, Ghost Voyage, IC Rex;
Matteo Baroni - Nocturnal Depression, Exitium, Apocryphal, Skorbutiks;
Modii - Nocturnal Depression, Helegion, Ordalie, Aldaaron, Electric Shock, Sanctuaire, Supplicium, Empires de Glace;
Morkhod - Nocturnal Depression, Mutilanova, Grim Landscape;
N. - Totalselfhatred, Korgonthurus;
Nachtzeit - Hypothermia, Gråande, Inlandshjärta, Lustre, Nachtzeit, Mortem Parto Humano, Durthang, Life Neglected, The Burning, Ered Wethrin, Rafnatyr, Ebon Lore, Eitr, Messier, Starlit, Uruz, Nihilum (Swe);
Nattetale - Make a Change... Kill Yourself, Myrd, Plage, Angantyr, Holmgang, Monomania, Phrenetic, Usipian, Vardlokkur, Mara, Nocturnal Depression, Ad Noctum, Mzoraxc, Zahrim, Phantom (Dnk);
Nattramn - Silencer, Diagnose: Lebensgefahr, Sinneskross, Trencadis;
Nepho - Psychonaut 4, Signs, Circus Mircus, Gamouvali Mdgomareoba;
Nila Ojeda - Sadness, Nila Ojeda;
Non - Hypothermia, Malign, Monstraat, IXXI, Kafziel, Lifelover, Woundism;
Obeyron - Nocturnal Depression, Grim Landscape, Ruines Humaines;
Patrik - Hypothermia, Vedervilja, Kall, DödVind, Passionless;
Patrik Michaelsen - Hypothermia, Malign, Monstraat, IXXI, Kafziel, Lifelover, Woundism;
Peter - Lifelover, Canopy, Kall, Chainsaw, Decadence, Sterbhaus, A-Bros;
Phil A. Cirone - Kall, Craft, Hypothermia, Strapats, Zornheym, Seid, Shining, Incinerate / Tyrant;
R. - Lifelover, Libricum, IXXI;
Richard Abrams - Hypothermia, Sitra Ahra, Through the Pain, Iblis Industries;
S. - Totalselfhatred, Korgonthurus, Ymir, Horna, Sear;
S. - Lifelover, Libricum, IXXI;
S.D. Ramirez - Psychonaut 4, Signs, Circus Mircus, Gamouvali Mdgomareoba;
Santino van der Aa - Hypothermia, Dodenbezweerder, Aardling;
Sathrath - Nocturnal Depression, Chronic Hate, Mass Carnage, Patristic, Helion, Infernal Angels, Evil Lucifera, Minotauro;
Sattvahr - Nocturnal Depression, Exhaustus, Mother Augusta, Tulpa, Whiskey Ritual, Morbid Upheaval, Uncreation;
Shi Ning - Shining, Skeletal Augury;
Skogsvandrer - Make a Change... Kill Yourself, Angantyr, Myrd, Autarcie, Scythe, Hasserben, Caterva Runa, Myrkvid, Sacrificia Mortuorum;
Sofia - Kall;
Sofia - Kall, Vedervilja, Hypothermia, DödVind, Passionless;
T. - Totalselfhatred, Kausalgia, Dyessence, Dark Premonition, Hypotermia;
Teithan - Xasthur, Profancer;
Thophet - Xasthur, Fyraun, Impiety, Sadiztik Impaler, Profancer;
V. - Nocturnal Depression, Myrd, Plage, Angantyr, Make a Change... Kill Yourself, Holmgang, Monomania, Phrenetic, Usipian, Vardlokkur, Mara, Ad Noctum, Mzoraxc, Zahrim, Phantom (Dnk);
Valr - Nocturnal Depression, Bodyfarm, Deathless Void, Weltschmerz, Wrang, Chotzä, Glorior Belli, Helleruin, Wesenwille, Iron Harvest, Verwoed, Grafjammer, Funeral Whore, Khaoz;
Vrede - Make a Change... Kill Yourself, Myrd, Plage, Angantyr, Holmgang, Monomania, Phrenetic, Usipian, Vardlokkur, Mara, Nocturnal Depression, Ad Noctum, Mzoraxc, Zahrim, Phantom (Dnk);
Xalmstad - Nocturnal Depression, Grim Landscape, Pavillon Rouge;
Ynleborgaz - Make a Change... Kill Yourself, Angantyr, Ignoble, Profezia, Myrd, Tågefolket, Holmgang, Vardlokkur, Blodarv, Mara, Illuminous;
